########S###########
#   #          #
#   #          #
#   #          #
#   #         ##
#   #         ##
#   #
    E