########S###########
#   #          #
#   #          #
#   #          #
#   #         ##
#   #         #E
#   #
